1111111111111
10000000000C1
1001111110011
1P111100001E1
1111111111111