1111111111111
10E0000000101
1001111110011
1P11110000001
1111111111111