1111111111111
100010P0000C1
1001111110011
101111E000001
1111111111111