1111111111111
10C1000000C11
10C0011111011
1P0011E0C0001
1111111111111