1111111111111111111111111111111111
1E00M0000000000C00000C000000000001
101001010010000010100100M0M0010101
1010010010101010001001000000010101
1P0000000C00C000000M000000000000C1
1111111111111111111111111111111111