1111111111111
10000000000C1
1001111110011
1P11110000001
1111111111111