1111111111111111111111111111111111
1E1000000000000C00000C000000000001
1111110100100X00001010010000010101
1000010010101010001001000000010101
1P0001000C00C0000000000000000000C1
1111111111111111111111111111111111