1111111111111
10E00000001C1
1001111110011
1P1111000C001
1111111111111